S^LLAWGATlOMi
msd am, w&ch ought to be-short, we equally use the common long sound of the vowels: but in the oblique cases, Merit, nonatti*, mUeri, onerU, See. we tise quite another sound, and that a short one : and this analogy runs through the whole English pronunciation of the learned languages. (533j (535).
544.	But the small dependence of the English quantity 6n that of the Latin will be best seen by a selection of woTds of two syllables, with the accent on the first, and but one consonant in the miildle, and comparing them with tne Latin words from which they are derived. <	•	1
I	.	'	'	*	.	v'	.
Eng&sh dissyllables vohich hauebut one corUonant, orti.mute and liquid in tkemiddle9 and have the first-syllable accented, contrasted with -the Latin words from which they are derived, marked with their respective quantities:	•
Words m which the first vowel in both languages is long:
plica,	pica.	penal, ' ’	pcenalis.
drama,	drlma. '	final,	finals. ’
tibra,	labra, libra, hydra. ! • 1	spinal,	spinalis.
hjdra,		trtnal,	n.rinus.
	sera. *	hSraJ,	hora.
strata,	strata.	thdral, •	thdra.
Icon,	’UKVV. .	floral, . .	floralis. nasus.
stipend,	stipendium.	nasaf, '	
notice,	notitia.	fatal, . :	fatuiis.
frtgrance,	frl^ro. •	natal, »	natalis. *
license,	lTcentia.	vital, . ;	vita i s. ■
credence,	crcdentia.	naval, .	navaiis.
female,	fcemina.	rival, ‘ :	rivalis.
edile,	aedilis.	6val,	Cvalis.
feline,	felrnus.	Idol,	Idolum.
risure,	rasura.	grecism,	grsecismua.
fibre,	fibra, fibra.	pagan,	pl^anus.
m^tre,.	metrum, m&rum. omen,		6men.
nature,	natQra.	siren, '	siren.
plicate,	piacatus.	siphon,	o-t$fcy, siphon.
primate,	prim at us.	cGion,	KsuXo», c6ion.
climate,	clima.	demon,	daemon.
Ebrate,	libratus.	halo,	halo.
vibrate,	vibro, vibro.	SOiO,	soo.
private,	privltus.	tyro,	tiro.
cerate,	ceratus.	sdiar,	souris.
finite,	finitus.	lazar,	laz itus.
levite,	lfev’ta.	s5ber,	sol.rius.
native,	nativus.	tyger,	tigris, tigris,
motive,	motivus.	ether,	aether.
▼Stive,	votivus.	oker,	*XPa-
vocal,	vScaiis.	mimei^	mi mils.
predal,	prada.	caper,	capparis.
regal,	regalis.	vijer,	vipera.
legal,	lesralis.	pretor,	prsetor.
flavour,	flSvus.	liinous,	limosus.
feces,	faeces.	spin US|	spiiosus.
manes*	man^s.	vinouj, q Digitized by (jOCK^IC	fjndsus*